-----------------------------------------------------------
-----------------------------------------------------------
-----------------------------------------------------------
-----------------------------------------------------------
-----------------------------------------------------------
----------X------------------------------------------------
----------X--------------------------------X---------------
----------X--X-----------------------------X---------------
---------XX--XX----------------------------X---------------
--------XXX--XXX---------------------------X---------------
-------XXXX--XXXX-------------------------XXXX-------------
------XXXXXXXXXXXX-----------------------XXXXXX------------
-----XXXXXXXXXXXXXX-----------------XXX-XXXXXXXXXX--XX-----
XXXXXXXXXXXXXXXXXXXXXXXX--------XXXXXXXXXXXXXXXXXXXXXXXXXXX
